ablation - удаление, абляция
accept - принимать, признавать
accidental - случайный
accurate - точный
act - действовать
advance - продвижение, достижение
affect - воздействовать, влиять
answer - ответ
apparent - очевидный, явный
approach - подход, приближаться
arouse - пробуждать, вызывать
attempt - попытка, пытаться
aware - осознающий
be aware of - осознавать
behave - вести себя
belief - вера, убеждение
bodily - телесный, физический
brain - мозг
brighten - освещать, делать ярче
cerebral - мозговой, церебральный
clear - ясный, понятный
complex - сложный
concern - беспокойство, касаться
connection - связь, соединение
conscious - сознательный, в сознании
constrict - сужать
contest - соревнование, конкурс
continue to be - оставаться
controlled - контролируемый
convince - убеждать
cortex - кора (мозга)
correlation - корреляция, взаимосвязь
damage - повреждение, повреждать
data - данные
debate - дебаты, дискутировать
decrease - уменьшение, уменьшаться
defend - защищать
describe - описывать
determine - определять
develop - развивать(ся)
different - различный, другой
difficult - трудный
dilate - расширять
discover - открывать, обнаруживать
discuss - обсуждать
dispute - спор, оспаривать
disprove - опровергать
distinct - отчётливый, явный
doubt - сомнение
emphasis - акцент, Emphasis
environment - окружающая среда, обстановка
estimate - оценивать
evident - очевидный
excite - возбуждать
explore - исследовать, изучать
expression - выражение
extreme - крайний, экстремальный
facilitate - облегчать, способствовать
fairly - довольно, справедливо
feeling - чувство, ощущение
final - окончательный, конечный
findings - результаты, находки
find out - выяснять
grow - расти, выращивать
gut feeling - интуитивное чувство
hemisphere - полушарие
illuminate - освещать
immediate - немедленный, непосредственный
implant - имплантировать, имплант
impulse - импульс, побуждение
include - включать в себя
increase - увеличение, увеличивать(ся)
influence - влияние, влиять
inhibit - подавлять, тормозить
injury - травма, повреждение
insert - вставлять, ввод
insist - настаивать
instinct - инстинкт
instant - мгновенный
intense - интенсивный, сильный
introduce - представлять, внедрять
investigate - исследовать, расследовать
investigation - исследование, расследование
involve - вовлекать, включать
knowing - знающий, осведомлённость
light up - освещать, загораться
link - связь, связывать
local - местный, локальный
mask - маскировать, маска
memorize - запоминать
method - метод, способ
muscular - мышечный
mystery - тайна, загадка
narrow - узкий, сужать
obtain - получать
observe - наблюдать
obvious - очевидный
occasional - случайный, периодический
opposition - противодействие, оппозиция
particularly - особенно
persuade - убеждать
physical - физический
powerful - мощный, сильный
precise - точный
prevent - предотвращать
pretend - притворяться
proper - правильный, надлежащий
protect - защищать
purpose - цель, назначение
quick - быстрый
raise - поднимать, повышать
rather - довольно, скорее
rapid - быстрый, стремительный
realize - осознавать, реализовывать
refuse - отказывать(ся)
refute - опровергать
relieve - облегчать
remember - помнить
removal - удаление
remove - удалять
repair - ремонт, ремонтировать
research - исследование
respond - отвечать, реагировать
results - результаты
realize - осознавать, понимать
sense - чувство, смысл
sentence - предложение (грам.), приговор
simulate - имитировать, симулировать
specify - конкретизировать, указывать
stable - стабильный, устойчивый
stay - оставаться
strong - сильный
study - изучать, исследование
support - поддерживать, поддержка
surroundings - окружение, окружающая обстановка
technique - техника, метод
truth - правда, истина
trust - доверие, доверять
tumor - опухоль
ultimate - конечный, абсолютный
unconscious - бессознательный, без сознания
various - различный, разнообразный
voluntary - добровольный, произвольный
watch - наблюдать, смотреть
widen - расширять(ся)
word - слово
