accept - принимать, признавать 
acceptable - приемлемый, допустимый
aim - цель, задача, намерение
arrange - приводить в порядок, систематизировать, договориться
aid - помощь, поддержка
aids - вспомогательные слова, пособия
attend a meeting - присутствовать на собирании
assign - назначать, поручать
amount - количество, величина
allocate - предназначать
approach - подход (к рассмотрению, изучению чего-л.); подходить, приближаться
aware - знающий, осведомленный
assert - утверждать, заявлять; отстаивать
assertive - чрезмерно настойчивый, самоуверенный, напористый
ambiguous - двусмысленный, неясный, нечеткий, неопределенный, допускающий двойное толкование
anticipate - ожидать, предвидеть, предубеждать, предвосхищать
attach - прикреплять 
attachment n - прикрепление, присоединение; информация, прикрепленная к сообщению
append - прикреплять (что-л. к письму), присоединять; ставить (подпись)
blocked style - блочный стиль
by means of - посредством
bar graph - гистограмма
ballot - избирательный бюллетень
benefit - выгода, польза, прибыль; по-могать, приносить пользу; извлекать пользу, выгоду
beneficial - выгодный, полезный
call back - перезвонить
clarify - делать ясным, вносить ясность
clarification - прояснение
courteous - вежливый, учтивый
congratulation letter - поздравительное письмо
closure - заключительная формула (письма) 
complimentary closure - заключительная формула вежливости (письма)
customer - клиент, заказчик, покупатель
capital (letter) - прописная буква
chart - диаграмма, схема, таблица, график, план
content - содержание, суть
confidence - уверенность, доверие
call a meeting - созвать собрание
chairperson - председатель
charge - обязанности, ответственность, поручать, вверять
be in charge - отвечать, заведовать
cast a vote - проголосовать
count - счет, подсчет, считать
carry - принимать решение при голосовании
check off - отмечать галочкой 
contribute - делать вклад, способство-вать, содействовать
commit - поручать, вверять; совершать, принимать на себя обязательства
commitment - обязательство; вручение, передача; совершение
contend - соперничать, состязаться, спорить
concede - уступать, проигрывать, признавать поражение
concede a point (in an argument) - уступить (сдаться) в каком-л. вопросе (в споре)
concession - уступка
contain - содержать в себе, вмещать
cover(ing) letter - сопроводительное письмо
dial - набирать номер (по телефону), зво-нить; наборный диск
dial the number - набирать номер по телефону 
dial a wrong number - не туда попасть
directory - руководство, справочник 
distinct - отчетливый, ясный, внятный
discourteous - невоспитанный, невежливый
delete - стирать, вычеркивать
destination - место назначения
engage - занимать, заниматься (чем-л.)
enquiry (inquiry) letter - письмо-запрос
enclose - прилагать, вкладывать (в письмо)
enclosure - приложение
enable - давать возможность или право (что-л. сделать), создавать возможность
easel - подставка, стенд
estimate - оценка
feature - особенность, характерная черта, признак, свойство; изображать, быть характерной чертой
flow chart - блок схема, график последовательности операций
in favour - за при голосовании
fail - отклонить, не принять, при голосовании
facilitate - облегчать, помогать
forward - отправлять, пересылать, посылать
face - сталкиваться (с необходимостью), наталкиваться (на трудности)
face a task - стоять перед необходимостью, решать задачу
goodwill - доброжелательность, добрая воля
graph - график, диаграмма
glance - быстрый взгляд, бросить взгляд
give a glance - взглянуть
give in - уступать, сдаваться
give in to demands - уступать требованиям
hold on v - не класть трубку 
hang on v - ожидать (у телефона) 
hang up v - положить телефонную трубку, прекратить телефонный разговор
handout - раздаточный материал
hold a meeting - проводить собрание
have (take) the floor - выступать, брать слово
invitation letter - письмо-приглашение
indented style - стиль с отступом 
illegible - нечеткий, неразборчивый (о почерке)
invaluable - неоценимый, бесценный
jot down - кратко записать
keep in touch with smb - поддерживать связь (контакт) с кем-л.
lift the receiver - поднять трубку
look up v - искать (в справочнике, словаре и т.п.)
long-distance call - междугородный или международный телефонный звонок
letter of request - письмо-просьба
letter of advice - уведомительное письмо
letter of credit, L/C - аккредитив
letter of thanks - благодарственное письмо
letter of apology - письмо с извинением
letter of confirmation - письмо-подтверждение
letter of acknowledgement - письмо, под-тверждающее что-л.
letter of guarantee - гарантийное письмо
letter of complaint - письмо-жалоба
letter of claim - письмо-рекламация 
letterhead - шапка на фирменном бланке
limited liability - ограниченная ответственность (членов товарищества/компании)
line graph - диаграмма в виде ломаной линии
long-term - долгосрочный, длительный
master a skill - овладеть умением (мастерством)
mouthpiece - микрофон
memo (a memorandum) - письмо с напоминанием (о чем-л.); памятная записка
mean (meant) - значить; подразумевать 
means - средство, способ; ресурсы 
matter - вопрос, дело; иметь значение 
misspell - делать орфографические ошибки, нисать с орфографическими ошибками
motion - предложение
master - овладевать (знаниями, языком и т.п.); руководить, управлять
the number/the line is engaged - номер занят/линия занята
negotiate - вести переговоры, договариваться
negotiation - переговоры, обсуждение условий
observe - соблюдать; наблюдать, замечать 
observe rules - соблюдать правила
order letter - письмо-заказ
order - порядок, последовательность; приказ, распоряжение; заказ
in order to - для того, чтобы
organization chart - схема организационной структуры
overheard projector - диапроектор 
open vote - открытое голосование
in opposition - против при голосовании
outcome - результат, последствие, исход
pick up the phone - снять телефонную трубку
put through - соединить (по телефону)
prompt - быстрый, немедленный
partnership - товарищество, компания
persuade - убеждать
pie chart - секторная диаграмма
private vote - закрытое голосование 
put to the vote - ставить на голосование
promote - повышать в должности
promotion - повышение в должности
put the motion to vote - поставить предложение на голосование
process - обрабатывать (документацию, книги и т.п.), подвергать обработке
precede - предшествовать, быть впереди
receiver - телефонная трубка
request - просьба, требование, запрос, заявка; просить разрешения, просить, запрашивать
refer - ссылаться
reference - ссылка
reverse - противоположный 
in a reverse order - идущий в обратном порядке
run a meeting - проводить, руководить собранием
roll call - перекличка
do roll call/call the roll - делать перекличку
resolve - решать голосованием
reply - ответ; отвечать
skill n - умение, мастерство, искусство
switchboard - коммутатор
switchboard operator - телефонистка
salutation - обращение
sign - подписывать(ся)
signature - подпись
suit - годиться, соответствовать, подходить match — подходить, соответствовать
spell - писать или произносить слово по буквам 
solve - решать
solution - решение 
suggest solutions - предлагать решение
sequential - последовательный, являющийся продолжением
in a sequential order - идущий по порядку
stay on track - следить за (напр. ходом мыслей)
staff - штаты, персонал
staff members - сотрудники
set a time limit - установить регламент
significant - знаменательный, важный, существенный
short-term - краткосрочный
schedule - программа, план, график; список, перечень; расписание
send an email to its destination - отправит электронную почту по адресу
store - хранить
stand for - означать, символизировать
sheet - лист (бумаги), листок; страница 
sheet of paper - лист (листик) бумаги cover(ing) 
sheet - сопроводительная страница
telephone directory - телефонный справочник
tip - совет, намек
term - срок, период, продолжительность, семестр, термин, условия
in terms of - с точки зрения, в смысле, в отношении
table - таблица
technique - метод, способ, прием
tie vote - равенство голосов
take the count of votes - подсчитать число голосов
time limit - регламент, предельный срок
transaction - сделка, дело
transmit - передавать, отправлять, посылать
tap - перехватывать (сообщение) 
tap the telephone (the line) - подслушивать телефонный разговор
treat - обращаться; относиться; трактовать
up-to-date - современный, соответству-ющий современным требованиям, новейший
urgent - срочный; крайне необходимый
visual aids - наглядные пособия
valuable - ценный, полезный, дорогостоящий
vote - голосование, голос
via - через, путем, с помощью
warm up - готовиться к чему либо, разогреться условно
with respect to - что касается…
yield - уступать, соглашаться (на что-л.)
yield a point - сделать уступку (в споре)
